Station,TotalDatos,Estado_0PSO,Estado_0PAT,Estado_0PER,Estado_0P,Per_0PSO,Per_0PAT,Per_0PER,Per_0P
11025501,534143,296078,313,10836,307227,55.43,0.06,2.03,57.52
11030010,42070,2359,93,8524,10976,5.61,0.22,20.26,26.09
11035030,19751,1059,52,5284,6395,5.36,0.26,26.75,32.38
11045010,44114,3562,132,3014,6708,8.07,0.3,6.83,15.21
11050020,20954,1105,23,3099,4227,5.27,0.11,14.79,20.17
11080010,34518,2678,24,3275,5977,7.76,0.07,9.49,17.32
11105020,46337,869,12088,18495,31452,1.88,26.09,39.91,67.88
11115020,26890,1882,58,426,2366,7.0,0.22,1.58,8.8
11115501,103586,57106,2,1020,58128,55.13,0.0,0.98,56.12
11120040,11005,738,10,3359,4107,6.71,0.09,30.52,37.32
11135030,12500,1566,15,68,1649,12.53,0.12,0.54,13.19
11155030,1064,98,203,578,879,9.21,19.08,54.32,82.61
11159010,72188,8309,3154,8573,20036,11.51,4.37,11.88,27.76
11175000,36106,1045,3878,19815,24738,2.89,10.74,54.88,68.51
12015060,46872,3702,341,1071,5114,7.9,0.73,2.28,10.91
12015100,79895,0,17838,24426,42264,0.0,22.33,30.57,52.9
12015110,83729,6284,6003,20425,32712,7.51,7.17,24.39,39.07
12025040,26583,1690,338,7882,9910,6.36,1.27,29.65,37.28
12045020,34571,3558,17,170,3745,10.29,0.05,0.49,10.83
13035501,67972,6806,6455,12039,25300,10.01,9.5,17.71,37.22
13055040,87722,6989,2082,12717,21788,7.97,2.37,14.5,24.84
13085030,19038,1622,9,37,1668,8.52,0.05,0.19,8.76
13085050,43032,0,37,3630,3667,0.0,0.09,8.44,8.52
13095010,73406,4859,80,29874,34813,6.62,0.11,40.7,47.43
14015010,43392,3426,509,6822,10757,7.9,1.17,15.72,24.79
14015020,40584,2675,46,217,2938,6.59,0.11,0.53,7.24
14015080,34039,2794,47,505,3346,8.21,0.14,1.48,9.83
14017001,54022,9992,381,966,11339,18.5,0.71,1.79,20.99
15015050,1802,91,7,0,98,5.05,0.39,0.0,5.44
15015060,45596,4938,877,5419,11234,10.83,1.92,11.88,24.64
15015100,24546,3052,813,10134,13999,12.43,3.31,41.29,57.03
15015120,105464,8973,1103,967,11043,8.51,1.05,0.92,10.47
15035020,12883,668,20,789,1477,5.19,0.16,6.12,11.46
15065040,76934,3934,519,10057,14510,5.11,0.67,13.07,18.86
15065180,72774,8880,1699,232,10811,12.2,2.33,0.32,14.86
15065190,61800,6148,882,8189,15219,9.95,1.43,13.25,24.63
15065501,41980,3398,59,2028,5485,8.09,0.14,4.83,13.07
15075150,82020,8469,224,327,9020,10.33,0.27,0.4,11.0
15075501,45289,5613,145,48,5806,12.39,0.32,0.11,12.82
15079010,1279,78,2,0,80,6.1,0.16,0.0,6.25
15085030,33128,2435,8,295,2738,7.35,0.02,0.89,8.26
15085050,81977,8658,5752,16289,30699,10.56,7.02,19.87,37.45
16015110,116771,10481,164,88,10733,8.98,0.14,0.08,9.19
16015120,75755,5867,240,497,6604,7.74,0.32,0.66,8.72
16015130,102852,8070,530,1263,9863,7.85,0.52,1.23,9.59
16015501,62538,4992,313,1242,6547,7.98,0.5,1.99,10.47
16015502,633891,327147,30,99557,426734,51.61,0.0,15.71,67.32
16025040,47225,2858,34,35,2927,6.05,0.07,0.07,6.2
16025501,486614,238822,103,123497,362422,49.08,0.02,25.38,74.48
16025502,91198,45097,25,14105,59227,49.45,0.03,15.47,64.94
16025503,550372,276973,105,97356,374434,50.32,0.02,17.69,68.03
16035010,13010,1070,655,4116,5841,8.22,5.03,31.64,44.9
16035030,26062,5209,25,139,5373,19.99,0.1,0.53,20.62
16035501,105488,48446,46,23244,71736,45.93,0.04,22.03,68.0
16040050,46557,2211,30,213,2454,4.75,0.06,0.46,5.27
16055120,76610,3309,11602,37562,52473,4.32,15.14,49.03,68.49
16055501,563139,299941,312,128397,428650,53.26,0.06,22.8,76.12
17015010,73230,10183,353,1693,12229,13.91,0.48,2.31,16.7
17017001,34466,6186,509,6850,13545,17.95,1.48,19.87,39.3
17025020,20489,2016,79,625,2720,9.84,0.39,3.05,13.28
17035010,39003,18523,767,19017,38307,47.49,1.97,48.76,98.22
21015030,21404,1104,6,5836,6946,5.16,0.03,27.27,32.45
21015040,106715,8799,140,3808,12747,8.25,0.13,3.57,11.94
21015050,88755,7214,909,7126,15249,8.13,1.02,8.03,17.18
21015060,105694,11103,247,4426,15776,10.5,0.23,4.19,14.93
21015070,121240,8733,461,7117,16311,7.2,0.38,5.87,13.45
21015501,234392,132339,12,2101,134452,56.46,0.01,0.9,57.36
21015502,629126,345279,154,18884,364317,54.88,0.02,3.0,57.91
21025030,8349,766,20,11,797,9.17,0.24,0.13,9.55
21035040,12206,709,11,2,722,5.81,0.09,0.02,5.92
21035501,208328,139614,34,0,139648,67.02,0.02,0.0,67.03
21045010,131,65,0,0,65,49.62,0.0,0.0,49.62
21045501,495046,268841,80,26151,295072,54.31,0.02,5.28,59.6
21050060,11721,896,9,31,936,7.64,0.08,0.26,7.99
21050090,45896,2792,35,422,3249,6.08,0.08,0.92,7.08
21055020,959,216,105,0,321,22.52,10.95,0.0,33.47
21055070,101985,11269,186,160,11615,11.05,0.18,0.16,11.39
21055501,641374,355402,99,7359,362860,55.41,0.02,1.15,56.58
21065040,12155,686,14,25,725,5.64,0.12,0.21,5.96
21065501,496365,275204,58,2678,277940,55.44,0.01,0.54,56.0
21085030,905,235,106,0,341,25.97,11.71,0.0,37.68
21085501,215053,120857,46,47,120950,56.2,0.02,0.02,56.24
21095010,354,24,1,0,25,6.78,0.28,0.0,7.06
21105030,34397,1968,264,515,2747,5.72,0.77,1.5,7.99
21105040,11911,560,39,18,617,4.7,0.33,0.15,5.18
21105050,11979,632,27,5,664,5.28,0.23,0.04,5.54
21105501,97389,64286,66,3,64355,66.01,0.07,0.0,66.08
21115010,30273,1825,37,20,1882,6.03,0.12,0.07,6.22
21115100,151,19,3,0,22,12.58,1.99,0.0,14.57
21115170,108318,16363,2883,7702,26948,15.11,2.66,7.11,24.88
21115180,90777,5172,4985,12982,23139,5.7,5.49,14.3,25.49
21115501,569781,301614,11607,11916,325137,52.94,2.04,2.09,57.06
21125010,12170,702,13,10,725,5.77,0.11,0.08,5.96
21130050,4961,411,10,20,441,8.28,0.2,0.4,8.89
21135020,7292,889,30,10,929,12.19,0.41,0.14,12.74
21140120,4492,289,32,19,340,6.43,0.71,0.42,7.57
21145080,20896,1278,4,24,1306,6.12,0.02,0.11,6.25
21165501,554984,287176,352,46066,333594,51.74,0.06,8.3,60.11
21165502,368520,189802,5424,40565,235791,51.5,1.47,11.01,63.98
21185030,4198,429,4,4,437,10.22,0.1,0.1,10.41
21185080,12092,767,8,44,819,6.34,0.07,0.36,6.77
21185090,103139,9651,182,197,10030,9.36,0.18,0.19,9.72
21185501,580427,309148,859,46671,356678,53.26,0.15,8.04,61.45
21195120,40846,1928,70,13,2011,4.72,0.17,0.03,4.92
21195160,40001,3074,465,304,3843,7.68,1.16,0.76,9.61
21195170,131131,12497,3907,6179,22583,9.53,2.98,4.71,17.22
21195190,102347,7623,2226,2064,11913,7.45,2.17,2.02,11.64
21195501,272011,146736,1037,13847,161620,53.94,0.38,5.09,59.42
21195502,42858,587,2135,27704,30426,1.37,4.98,64.64,70.99
21197430,64423,4009,79,28201,32289,6.22,0.12,43.77,50.12
21201200,275946,0,3656,192537,196193,0.0,1.32,69.77,71.1
21201580,72729,0,1,72728,72729,0.0,0.0,100.0,100.0
21201980,485679,0,143,27687,27830,0.0,0.03,5.7,5.73
21202170,443301,0,83,1093,1176,0.0,0.02,0.25,0.27
21202180,442961,0,913,0,913,0.0,0.21,0.0,0.21
21202200,431288,344882,281,54204,399367,79.97,0.07,12.57,92.6
21202220,303933,0,7815,2978,10793,0.0,2.57,0.98,3.55
21202230,408243,0,353,3,356,0.0,0.09,0.0,0.09
21202240,308912,0,1255,174365,175620,0.0,0.41,56.44,56.85
21202250,406743,0,680,29,709,0.0,0.17,0.01,0.17
21205012,88823,4928,261,278,5467,5.55,0.29,0.31,6.15
21205480,107829,72421,203,2,72626,67.16,0.19,0.0,67.35
21205501,58631,31720,34,2023,33777,54.1,0.06,3.45,57.61
21205502,606129,330224,598,10263,341085,54.48,0.1,1.69,56.27
21205503,32481,2885,838,575,4298,8.88,2.58,1.77,13.23
21205505,37268,2647,630,3859,7136,7.1,1.69,10.35,19.15
21205506,35583,2838,152,121,3111,7.98,0.43,0.34,8.74
21205507,35447,2856,674,765,4295,8.06,1.9,2.16,12.12
21205509,166686,0,2954,33389,36343,0.0,1.77,20.03,21.8
21205511,175101,0,298,0,298,0.0,0.17,0.0,0.17
21205512,171647,0,5446,20650,26096,0.0,3.17,12.03,15.2
21205513,163349,0,26,0,26,0.0,0.02,0.0,0.02
21205514,105035,539,743,78838,80120,0.51,0.71,75.06,76.28
21205515,149886,14282,2276,118699,135257,9.53,1.52,79.19,90.24
21205516,148462,0,49513,499,50012,0.0,33.35,0.34,33.69
21205517,147401,21595,23574,82410,127579,14.65,15.99,55.91,86.55
21205518,137951,55846,61,37553,93460,40.48,0.04,27.22,67.75
21205519,157054,19903,1351,122375,143629,12.67,0.86,77.92,91.45
21205521,173482,72352,36294,18878,127524,41.71,20.92,10.88,73.51
21205522,106542,9442,2060,93255,104757,8.86,1.93,87.53,98.32
21205523,153679,44575,51,72402,117028,29.01,0.03,47.11,76.15
21205524,153210,16046,59865,63544,139455,10.47,39.07,41.48,91.02
21205525,137101,39284,47616,15744,102644,28.65,34.73,11.48,74.87
21205526,151403,78168,820,6568,85556,51.63,0.54,4.34,56.51
21205527,144434,22864,78316,19308,120488,15.83,54.22,13.37,83.42
21205660,42588,2266,38,73,2377,5.32,0.09,0.17,5.58
21205670,11623,851,275,25,1151,7.32,2.37,0.22,9.9
21205710,50002,3292,132,462,3886,6.58,0.26,0.92,7.77
21205791,73048,6138,655,6012,12805,8.4,0.9,8.23,17.53
21205910,25139,4715,23,132,4870,18.76,0.09,0.53,19.37
21205940,43111,3212,85,831,4128,7.45,0.2,1.93,9.58
21205970,124243,11437,1735,11715,24887,9.21,1.4,9.43,20.03
21206280,31922,3126,599,1191,4916,9.79,1.88,3.73,15.4
21206560,750,114,4,12,130,15.2,0.53,1.6,17.33
21206600,92573,7306,8957,27442,43705,7.89,9.68,29.64,47.21
21206780,316415,0,31,8,39,0.0,0.01,0.0,0.01
21206790,120287,11018,1666,11288,23972,9.16,1.39,9.38,19.93
21206810,447937,0,86,4,90,0.0,0.02,0.0,0.02
21206890,293798,0,641,168212,168853,0.0,0.22,57.25,57.47
21206900,68082,0,1121,54479,55600,0.0,1.65,80.02,81.67
21206920,113039,13474,1868,8071,23413,11.92,1.65,7.14,20.71
21206930,129696,13393,1247,5660,20300,10.33,0.96,4.36,15.65
21206940,65868,1920,1444,33065,36429,2.91,2.19,50.2,55.31
21206950,128017,13203,4557,10708,28468,10.31,3.56,8.36,22.24
21206960,111206,7740,869,40,8649,6.96,0.78,0.04,7.78
21206980,117092,10190,2248,842,13280,8.7,1.92,0.72,11.34
21206990,139099,13835,264,4453,18552,9.95,0.19,3.2,13.34
21208480,326819,0,56,4,60,0.0,0.02,0.0,0.02
21209940,207101,0,86,25530,25616,0.0,0.04,12.33,12.37
21215150,100901,9766,8362,33901,52029,9.68,8.29,33.6,51.56
21215160,109247,10494,3209,12080,25783,9.61,2.94,11.06,23.6
21215170,21198,5023,415,41,5479,23.7,1.96,0.19,25.85
21215180,109105,6951,4737,8152,19840,6.37,4.34,7.47,18.18
21215190,112563,9780,335,2069,12184,8.69,0.3,1.84,10.82
21215501,619065,302228,4830,136645,443703,48.82,0.78,22.07,71.67
21235030,114827,10330,669,1781,12780,9.0,0.58,1.55,11.13
21237020,2,0,0,2,2,0.0,0.0,100.0,100.0
21237060,114278,75865,308,649,76822,66.39,0.27,0.57,67.22
21255090,195,26,1,0,27,13.33,0.51,0.0,13.85
21255160,129740,8994,928,13690,23612,6.93,0.72,10.55,18.2
21255170,121726,9246,1016,30512,40774,7.6,0.83,25.07,33.5
21255501,471799,255474,1042,11318,267834,54.15,0.22,2.4,56.77
22020020,7691,820,21,4,845,10.66,0.27,0.05,10.99
22025040,16326,1969,6457,574,9000,12.06,39.55,3.52,55.13
22025501,595009,308827,1647,59371,369845,51.9,0.28,9.98,62.16
22045010,19832,1370,18,224,1612,6.91,0.09,1.13,8.13
22045502,622478,344918,42,12444,357404,55.41,0.01,2.0,57.42
22055020,11473,1085,19,49,1153,9.46,0.17,0.43,10.05
22065040,7706,810,32,40,882,10.51,0.42,0.52,11.45
22070030,12031,628,87,12,727,5.22,0.72,0.1,6.04
22075050,64238,5790,487,13472,19749,9.01,0.76,20.97,30.74
23015501,344068,179136,4367,33647,217150,52.06,1.27,9.78,63.11
23020080,94,26,0,0,26,27.66,0.0,0.0,27.66
23025040,11730,786,46,19,851,6.7,0.39,0.16,7.25
23025501,592429,328710,62,632,329404,55.49,0.01,0.11,55.6
23025502,511817,214133,2445,202450,419028,41.84,0.48,39.56,81.87
23035030,95221,10132,959,8868,19959,10.64,1.01,9.31,20.96
23055501,224869,108200,89,65297,173586,48.12,0.04,29.04,77.19
23055502,538406,281064,10103,61402,352569,52.2,1.88,11.4,65.48
23065110,43124,2870,211,375,3456,6.66,0.49,0.87,8.01
23065120,12034,697,58,24,779,5.79,0.48,0.2,6.47
23065160,104768,69677,127,9202,79006,66.51,0.12,8.78,75.41
23065180,147643,9506,6980,29400,45886,6.44,4.73,19.91,31.08
23065190,100249,6823,1961,7566,16350,6.81,1.96,7.55,16.31
23065501,280827,134229,1036,37044,172309,47.8,0.37,13.19,61.36
23065502,407253,205740,106,77784,283630,50.52,0.03,19.1,69.64
23065503,246805,137157,810,9310,147277,55.57,0.33,3.77,59.67
23065504,33336,3538,455,3504,7497,10.61,1.36,10.51,22.49
23065505,38711,4833,130,404,5367,12.48,0.34,1.04,13.86
23065506,96537,46954,252,4417,51623,48.64,0.26,4.58,53.47
23065507,16244,0,420,0,420,0.0,2.59,0.0,2.59
23067020,2974,1415,16,284,1715,47.58,0.54,9.55,57.67
23085080,29252,2610,5,1299,3914,8.92,0.02,4.44,13.38
23085260,86689,8505,121,4910,13536,9.81,0.14,5.66,15.61
23085270,73869,5663,748,7707,14118,7.67,1.01,10.43,19.11
23085501,588166,307828,535,92686,401049,52.34,0.09,15.76,68.19
23097030,1,0,0,0,0,0.0,0.0,0.0,0.0
23105060,61167,5621,272,781,6674,9.19,0.44,1.28,10.91
23105070,126638,9062,732,15151,24945,7.16,0.58,11.96,19.7
23115010,6350,1240,19,1,1260,19.53,0.3,0.02,19.84
23125140,32462,2361,24,460,2845,7.27,0.07,1.42,8.76
23125160,102839,19646,6771,23718,50135,19.1,6.58,23.06,48.75
23125170,96602,7807,1374,2111,11292,8.08,1.42,2.19,11.69
23125501,594645,299586,1979,97501,399066,50.38,0.33,16.4,67.11
23155030,6551,1117,16,4,1137,17.05,0.24,0.06,17.36
23180070,31158,2625,7,171,2803,8.42,0.02,0.55,9.0
23190130,36095,2659,260,425,3344,7.37,0.72,1.18,9.26
23190700,23273,4602,8,27,4637,19.77,0.03,0.12,19.92
23195040,3531,49,48,2914,3011,1.39,1.36,82.53,85.27
23195090,43799,2345,72,120,2537,5.35,0.16,0.27,5.79
23195110,17966,1378,5,9,1392,7.67,0.03,0.05,7.75
23195190,44792,6197,842,3154,10193,13.84,1.88,7.04,22.76
23195200,43819,1830,560,90,2480,4.18,1.28,0.21,5.66
23195230,88138,5054,497,7417,12968,5.73,0.56,8.42,14.71
23195240,55657,5424,4471,7602,17497,9.75,8.03,13.66,31.44
23195501,34944,18348,19,557,18924,52.51,0.05,1.59,54.16
23195502,73242,4101,2292,16303,22696,5.6,3.13,22.26,30.99
23205050,32889,2336,355,817,3508,7.1,1.08,2.48,10.67
24010390,54721,4458,177,647,5282,8.15,0.32,1.18,9.65
24015110,122976,8505,188,231,8924,6.92,0.15,0.19,7.26
24015300,34047,2169,33,94,2296,6.37,0.1,0.28,6.74
24015340,35915,2717,222,1855,4794,7.57,0.62,5.16,13.35
24015380,22104,1165,29,33,1227,5.27,0.13,0.15,5.55
24015501,620277,326774,273,67837,394884,52.68,0.04,10.94,63.66
24015502,39926,19674,1645,7770,29089,49.28,4.12,19.46,72.86
24015503,621914,324117,876,84705,409698,52.12,0.14,13.62,65.88
24015504,34240,3164,482,810,4456,9.24,1.41,2.37,13.01
24015506,33924,3245,637,1096,4978,9.57,1.88,3.23,14.67
24015507,166303,106164,16282,19697,142143,63.84,9.79,11.84,85.47
24015508,172434,90113,720,3207,94040,52.26,0.42,1.86,54.54
24015513,1165,109,2,0,111,9.36,0.17,0.0,9.53
24025030,41586,2521,274,1147,3942,6.06,0.66,2.76,9.48
24025050,30000,5676,43,0,5719,18.92,0.14,0.0,19.06
24025090,104319,10646,830,9732,21208,10.21,0.8,9.33,20.33
24025501,493082,221404,2721,97872,321997,44.9,0.55,19.85,65.3
24027070,1,0,0,1,1,0.0,0.0,100.0,100.0
24030350,197,22,0,0,22,11.17,0.0,0.0,11.17
24030680,44012,3242,537,3048,6827,7.37,1.22,6.93,15.51
24030950,43468,1868,61,87,2016,4.3,0.14,0.2,4.64
24035250,44143,1910,76,73,2059,4.33,0.17,0.17,4.66
24035340,28449,2889,76,378,3343,10.16,0.27,1.33,11.75
24035360,137784,7088,302,8088,15478,5.14,0.22,5.87,11.23
24035370,122707,7765,1154,2892,11811,6.33,0.94,2.36,9.63
24035380,125208,8974,4890,11916,25780,7.17,3.91,9.52,20.59
24035390,136329,9688,1633,2047,13368,7.11,1.2,1.5,9.81
24035410,131277,10883,3040,14042,27965,8.29,2.32,10.7,21.3
24035430,131952,15535,358,9863,25756,11.77,0.27,7.47,19.52
24035440,8336,793,629,443,1865,9.51,7.55,5.31,22.37
24035501,89136,50096,5,90,50191,56.2,0.01,0.1,56.31
24037620,7233,418,181,8,607,5.78,2.5,0.11,8.39
24055070,98653,9755,7562,21202,38519,9.89,7.67,21.49,39.04
24055080,128825,12747,164,14181,27092,9.89,0.13,11.01,21.03
24055501,359961,172545,1122,42686,216353,47.93,0.31,11.86,60.1
25010010,13195,1392,14,1068,2474,10.55,0.11,8.09,18.75
25015020,85994,7314,354,40251,47919,8.51,0.41,46.81,55.72
25025000,64617,4435,65,4458,8958,6.86,0.1,6.9,13.86
25025002,43523,3287,28,815,4130,7.55,0.06,1.87,9.49
25025030,58755,6029,19,6370,12418,10.26,0.03,10.84,21.14
25025100,18659,1155,11,733,1899,6.19,0.06,3.93,10.18
25025190,39598,3233,7,266,3506,8.16,0.02,0.67,8.85
25025240,27714,2132,236,6971,9339,7.69,0.85,25.15,33.7
25025270,5471,523,7,16,546,9.56,0.13,0.29,9.98
25025280,76332,5853,2739,13413,22005,7.67,3.59,17.57,28.83
25025330,30946,3325,17,1187,4529,10.74,0.05,3.84,14.64
25025340,71403,4153,2523,17133,23809,5.82,3.53,23.99,33.34
25025350,116197,9761,6143,32357,48261,8.4,5.29,27.85,41.53
25025360,58426,3806,93,3978,7877,6.51,0.16,6.81,13.48
25025380,58188,4378,2849,18443,25670,7.52,4.9,31.7,44.12
25027720,247,50,4,47,101,20.24,1.62,19.03,40.89
26015010,120030,10839,643,6354,17836,9.03,0.54,5.29,14.86
26015030,71613,6506,2045,16082,24633,9.08,2.86,22.46,34.4
26015040,58277,2160,1138,17943,21241,3.71,1.95,30.79,36.45
26015050,27965,634,4529,13907,19070,2.27,16.2,49.73,68.19
26035090,29688,6646,96,165,6907,22.39,0.32,0.56,23.27
26035100,33043,3244,26,528,3798,9.82,0.08,1.6,11.49
26035501,12469,408,2559,9490,12457,3.27,20.52,76.11,99.9
26055100,100380,12711,464,4779,17954,12.66,0.46,4.76,17.89
26055110,142585,8522,997,22218,31737,5.98,0.7,15.58,22.26
26055120,118992,8374,855,13612,22841,7.04,0.72,11.44,19.2
26055501,141085,78861,40,242,79143,55.9,0.03,0.17,56.1
26065501,459032,230215,337,53472,284024,50.15,0.07,11.65,61.87
26065502,508899,256965,6771,83617,347353,50.49,1.33,16.43,68.26
26075120,145337,8651,461,4435,13547,5.95,0.32,3.05,9.32
26075150,60527,4377,2758,9095,16230,7.23,4.56,15.03,26.81
26075501,380708,195266,2657,26163,224086,51.29,0.7,6.87,58.86
26085160,48222,3800,83,192,4075,7.88,0.17,0.4,8.45
26085170,99375,10231,94,174,10499,10.3,0.09,0.18,10.57
26085501,578620,282331,299,114598,397228,48.79,0.05,19.81,68.65
26095320,118196,8915,4354,14939,28208,7.54,3.68,12.64,23.87
26105240,64195,5253,1046,3073,9372,8.18,1.63,4.79,14.6
26105250,125310,13683,281,3624,17588,10.92,0.22,2.89,14.04
26115090,112578,10061,3795,40591,54447,8.94,3.37,36.06,48.36
26115501,573498,315948,12,2441,318401,55.09,0.0,0.43,55.52
26125061,46509,2610,845,14823,18278,5.61,1.82,31.87,39.3
26125290,92241,6971,122,43,7136,7.56,0.13,0.05,7.74
26125300,126718,11415,2633,10549,24597,9.01,2.08,8.32,19.41
26125501,121035,64754,6,7105,71865,53.5,0.0,5.87,59.38
26125502,493877,267068,215,27856,295139,54.08,0.04,5.64,59.76
26125503,359203,177114,36,60165,237315,49.31,0.01,16.75,66.07
26125504,634754,350302,47,23818,374167,55.19,0.01,3.75,58.95
26125505,590310,329190,241,5278,334709,55.77,0.04,0.89,56.7
26125506,612185,335055,383,85784,421222,54.73,0.06,14.01,68.81
26125507,381736,178164,28790,55019,261973,46.67,7.54,14.41,68.63
26125508,635683,340210,18,46243,386471,53.52,0.0,7.27,60.8
26125509,548299,301286,83,8766,310135,54.95,0.02,1.6,56.56
26125710,57052,3709,838,4674,9221,6.5,1.47,8.19,16.16
26125720,16461,1495,51,1052,2598,9.08,0.31,6.39,15.78
26125740,16457,1807,249,1850,3906,10.98,1.51,11.24,23.73
26125760,16588,1594,208,994,2796,9.61,1.25,5.99,16.86
26135290,92958,13360,504,3356,17220,14.37,0.54,3.61,18.52
26135300,99653,8359,6518,25245,40122,8.39,6.54,25.33,40.26
26135310,25350,2582,148,12728,15458,10.19,0.58,50.21,60.98
26135320,97098,17391,3794,31190,52375,17.91,3.91,32.12,53.94
26135330,59241,7893,1734,6600,16227,13.32,2.93,11.14,27.39
26135501,573849,282289,1391,125361,409041,49.19,0.24,21.85,71.28
26135502,513990,283806,245,12183,296234,55.22,0.05,2.37,57.63
26135503,604485,311252,122,95337,406711,51.49,0.02,15.77,67.28
26145090,125777,14117,341,13411,27869,11.22,0.27,10.66,22.16
26145501,550222,282430,219,62500,345149,51.33,0.04,11.36,62.73
26145503,568488,316387,172,2700,319259,55.65,0.03,0.47,56.16
26145504,604588,323892,294,22659,346845,53.57,0.05,3.75,57.37
26145505,544063,273367,31,76061,349459,50.25,0.01,13.98,64.23
26145506,505295,259887,3363,53826,317076,51.43,0.67,10.65,62.75
26145507,450161,242103,1857,26297,270257,53.78,0.41,5.84,60.04
26145508,187807,101628,35,12850,114513,54.11,0.02,6.84,60.97
26155110,7214,424,49,36,509,5.88,0.68,0.5,7.06
26155150,15876,2103,578,3668,6349,13.25,3.64,23.1,39.99
26155170,25742,1306,94,95,1495,5.07,0.37,0.37,5.81
26155220,115553,10826,287,1139,12252,9.37,0.25,0.99,10.6
26155230,112698,9835,813,1744,12392,8.73,0.72,1.55,11.0
26155240,104111,9353,3636,5956,18945,8.98,3.49,5.72,18.2
26155250,101662,6317,4558,15906,26781,6.21,4.48,15.65,26.34
26155260,110932,7275,1962,3810,13047,6.56,1.77,3.43,11.76
26155270,93653,7311,6030,14646,27987,7.81,6.44,15.64,29.88
26155502,574915,285737,5623,104689,396049,49.7,0.98,18.21,68.89
26155503,554314,295456,5401,42433,343290,53.3,0.97,7.66,61.93
26155505,363534,200405,6,6875,207286,55.13,0.0,1.89,57.02
26157170,101845,7785,6547,35190,49522,7.64,6.43,34.55,48.62
26157190,31454,2134,224,11,2369,6.78,0.71,0.03,7.53
26165501,529150,279361,1013,61469,341843,52.79,0.19,11.62,64.6
26165502,305182,168672,7,730,169409,55.27,0.0,0.24,55.51
26175501,595181,293639,92,119800,413531,49.34,0.02,20.13,69.48
26175502,218698,122223,5,16898,139126,55.89,0.0,7.73,63.62
26180180,26140,1815,19,174,2008,6.94,0.07,0.67,7.68
26180250,49963,2484,221,316,3021,4.97,0.44,0.63,6.05
26185020,1482,222,6,1,229,14.98,0.4,0.07,15.45
26185030,39740,4740,185,4244,9169,11.93,0.47,10.68,23.07
26185050,94318,10005,1569,432,12006,10.61,1.66,0.46,12.73
26185501,579802,316506,148,60930,377584,54.59,0.03,10.51,65.12
26195501,279222,148618,13,26871,175502,53.23,0.0,9.62,62.85
26195502,431509,223567,18,57853,281438,51.81,0.0,13.41,65.22
26200120,2,0,0,0,0,0.0,0.0,0.0,0.0
26205501,629468,345988,74,15776,361838,54.97,0.01,2.51,57.48
26215501,367759,189487,230,46915,236632,51.52,0.06,12.76,64.34
26225060,91255,9556,361,1844,11761,10.47,0.4,2.02,12.89
26255030,130845,13905,993,7382,22280,10.63,0.76,5.64,17.03
27015280,106529,11952,782,20457,33191,11.22,0.73,19.2,31.16
27015290,109111,6464,719,3115,10298,5.92,0.66,2.85,9.44
27015300,46653,3651,254,3656,7561,7.83,0.54,7.84,16.21
27015310,99197,7662,616,7116,15394,7.72,0.62,7.17,15.52
27015320,137269,10691,1496,33153,45340,7.79,1.09,24.15,33.03
27015330,72516,3839,235,1108,5182,5.29,0.32,1.53,7.15
27015501,206495,106560,11354,27530,145444,51.6,5.5,13.33,70.43
28015070,13004,1302,16,288,1606,10.01,0.12,2.21,12.35
28015110,18895,1140,98,0,1238,6.03,0.52,0.0,6.55
28025090,18954,1178,10,727,1915,6.22,0.05,3.84,10.1
28025120,85902,6752,3288,10838,20878,7.86,3.83,12.62,24.3
28025130,90090,6334,206,7444,13984,7.03,0.23,8.26,15.52
28025501,29579,15469,57,0,15526,52.3,0.19,0.0,52.49
28025502,59440,4289,66,3079,7434,7.22,0.11,5.18,12.51
28035060,137508,8174,151,133,8458,5.94,0.11,0.1,6.15
28035070,61847,5308,2156,5441,12905,8.58,3.49,8.8,20.87
28045501,524628,265139,2029,120172,387340,50.54,0.39,22.91,73.83
29004520,103828,8205,530,24386,33121,7.9,0.51,23.49,31.9
29015000,71614,5534,136,2087,7757,7.73,0.19,2.91,10.83
29015040,93698,12812,1723,7405,21940,13.67,1.84,7.9,23.42
29035000,68283,5447,36,3823,9306,7.98,0.05,5.6,13.63
29035080,27251,1963,399,998,3360,7.2,1.46,3.66,12.33
29035200,58192,3795,216,652,4663,6.52,0.37,1.12,8.01
29045000,63337,4931,333,12802,18066,7.79,0.53,20.21,28.52
29045110,20157,1228,29,1715,2972,6.09,0.14,8.51,14.74
29045150,21973,2873,154,1716,4743,13.08,0.7,7.81,21.59
29045180,38,17,1,0,18,44.74,2.63,0.0,47.37
29045190,77090,6839,1274,5296,13409,8.87,1.65,6.87,17.39
29065000,54787,5241,292,6256,11789,9.57,0.53,11.42,21.52
29065120,112794,7026,2006,9335,18367,6.23,1.78,8.28,16.28
29065130,108506,8128,117,381,8626,7.49,0.11,0.35,7.95
29065140,16903,3033,91,399,3523,17.94,0.54,2.36,20.84
29065501,294611,164106,584,14510,179200,55.7,0.2,4.93,60.83
31095030,105687,10601,1080,9519,21200,10.03,1.02,9.01,20.06
32067030,6,0,0,6,6,0.0,0.0,100.0,100.0
32075501,207661,114247,95,799,115141,55.02,0.05,0.38,55.45
32105080,41233,4430,1589,7121,13140,10.74,3.85,17.27,31.87
33035010,15944,1481,325,4608,6414,9.29,2.04,28.9,40.23
35017020,2,0,0,1,1,0.0,0.0,50.0,50.0
35020300,22558,1455,146,3150,4751,6.45,0.65,13.96,21.06
35025080,117060,11075,1538,31694,44307,9.46,1.31,27.08,37.85
35025090,83470,8781,344,24198,33323,10.52,0.41,28.99,39.92
35025110,71368,6337,708,3113,10158,8.88,0.99,4.36,14.23
35025501,386670,215168,22,4976,220166,55.65,0.01,1.29,56.94
35025502,160726,0,268,5923,6191,0.0,0.17,3.69,3.85
35027510,103291,5121,545,34445,40111,4.96,0.53,33.35,38.83
35035100,123626,7864,369,2270,10503,6.36,0.3,1.84,8.5
35035110,106897,8500,4184,5635,18319,7.95,3.91,5.27,17.14
35035130,69301,5752,5423,29138,40313,8.3,7.83,42.05,58.17
35037100,1,0,1,0,1,0.0,100.0,0.0,100.0
35060210,10062,1752,24,152,1928,17.41,0.24,1.51,19.16
35075040,4983,493,11,463,967,9.89,0.22,9.29,19.41
35075070,51437,2471,49,8220,10740,4.8,0.1,15.98,20.88
35075080,128011,11480,3330,40116,54926,8.97,2.6,31.34,42.91
35075090,163821,111278,806,27720,139804,67.93,0.49,16.92,85.34
35080050,9867,1593,133,81,1807,16.14,1.35,0.82,18.31
35085060,142673,10431,523,15351,26305,7.31,0.37,10.76,18.44
35085070,140337,12119,1239,7900,21258,8.64,0.88,5.63,15.15
35085080,132424,8273,206,6198,14677,6.25,0.16,4.68,11.08
35095110,4523,906,16,14,936,20.03,0.35,0.31,20.69
35095120,144957,11677,1368,6193,19238,8.06,0.94,4.27,13.27
35095130,64172,9125,2405,6260,17790,14.22,3.75,9.76,27.72
35105050,36380,2925,34,357,3316,8.04,0.09,0.98,9.11
35165000,53777,3644,1328,22098,27070,6.78,2.47,41.09,50.34
35185010,120701,9979,3864,10957,24800,8.27,3.2,9.08,20.55
35195020,10702,1644,23,8,1675,15.36,0.21,0.07,15.65
35195050,1089,234,15,4,253,21.49,1.38,0.37,23.23
35195060,49160,4823,215,2115,7153,9.81,0.44,4.3,14.55
35215020,90558,9920,4110,4451,18481,10.95,4.54,4.92,20.41
35215030,21763,1847,62,68,1977,8.49,0.28,0.31,9.08
35225030,9566,1766,13,296,2075,18.46,0.14,3.09,21.69
35235010,34922,3382,1312,10107,14801,9.68,3.76,28.94,42.38
35235040,16905,1896,286,4458,6640,11.22,1.69,26.37,39.28
35235050,7430,2230,91,359,2680,30.01,1.22,4.83,36.07
35237040,74,69,0,5,74,93.24,0.0,6.76,100.0
35260050,12000,811,14,109,934,6.76,0.12,0.91,7.78
36015020,94112,12339,1181,7444,20964,13.11,1.25,7.91,22.28
36015501,514751,270542,1631,46917,319090,52.56,0.32,9.11,61.99
37015030,109577,9636,653,805,11094,8.79,0.6,0.73,10.12
37015501,193206,109047,23,364,109434,56.44,0.01,0.19,56.64
37045010,30822,1682,51,476,2209,5.46,0.17,1.54,7.17
44015060,89432,5665,1618,12451,19734,6.33,1.81,13.92,22.07
44015070,93171,11663,1307,10969,23939,12.52,1.4,11.77,25.69
44015501,23418,10698,616,6261,17575,45.68,2.63,26.74,75.05
44035040,86417,11595,2304,11829,25728,13.42,2.67,13.69,29.77
44035050,92498,11431,553,3884,15868,12.36,0.6,4.2,17.15
44035501,306142,160371,1008,22718,184097,52.38,0.33,7.42,60.13
44045030,857,0,857,0,857,0.0,100.0,0.0,100.0
44055010,23613,1441,552,12097,14090,6.1,2.34,51.23,59.67
46015030,84558,4981,1942,18689,25612,5.89,2.3,22.1,30.29
46035010,32563,2694,1544,7391,11629,8.27,4.74,22.7,35.71
47015100,46984,3442,100,386,3928,7.33,0.21,0.82,8.36
47035030,19590,1941,2296,12884,17121,9.91,11.72,65.77,87.4
48015010,34600,2550,63,119,2732,7.37,0.18,0.34,7.9
48015040,119894,16540,3029,51324,70893,13.8,2.53,42.81,59.13
48015050,31858,4286,1065,1605,6956,13.45,3.34,5.04,21.83
51025060,67608,6199,824,23549,30572,9.17,1.22,34.83,45.22
51025080,36665,3660,520,9042,13222,9.98,1.42,24.66,36.06
51025090,27830,11756,379,214,12349,42.24,1.36,0.77,44.37
51035020,21988,2573,9,72,2654,11.7,0.04,0.33,12.07
52015050,51026,4193,416,573,5182,8.22,0.82,1.12,10.16
52015501,594719,329988,179,2296,332463,55.49,0.03,0.39,55.9
52020070,10588,631,46,112,789,5.96,0.43,1.06,7.45
52025080,88815,7823,5004,8415,21242,8.81,5.63,9.47,23.92
52025090,91115,10864,267,8750,19881,11.92,0.29,9.6,21.82
52025501,226983,125298,92,10450,135840,55.2,0.04,4.6,59.85
52035040,101377,11586,104,20,11710,11.43,0.1,0.02,11.55
52035501,234131,130982,38,60,131080,55.94,0.02,0.03,55.99
52040050,43181,1944,29,494,2467,4.5,0.07,1.14,5.71
52045080,128345,10939,588,2418,13945,8.52,0.46,1.88,10.87
52050060,21434,1550,55,924,2529,7.23,0.26,4.31,11.8
52050080,22768,1252,59,599,1910,5.5,0.26,2.63,8.39
52050090,13143,1061,43,488,1592,8.07,0.33,3.71,12.11
52055090,22985,1381,75,849,2305,6.01,0.33,3.69,10.03
52055150,98445,4095,2853,71397,78345,4.16,2.9,72.52,79.58
52055160,6760,388,256,3131,3775,5.74,3.79,46.32,55.84
52055170,85784,7944,83,168,8195,9.26,0.1,0.2,9.55
52055210,115101,8976,245,1548,10769,7.8,0.21,1.34,9.36
52055220,110262,7986,91,13025,21102,7.24,0.08,11.81,19.14
52055230,46505,2287,1115,18824,22226,4.92,2.4,40.48,47.79
52055501,596685,310862,101,95562,406525,52.1,0.02,16.02,68.13
52055502,522767,268654,34,108504,377192,51.39,0.01,20.76,72.15
53045040,110208,8537,2220,19207,29964,7.75,2.01,17.43,27.19
53075020,60143,3688,956,19098,23742,6.13,1.59,31.75,39.48
53115501,577674,302010,46,89190,391246,52.28,0.01,15.44,67.73
53115502,564841,310871,1825,19646,332342,55.04,0.32,3.48,58.84
54010010,9443,1132,15,518,1665,11.99,0.16,5.49,17.63
54015010,27378,1677,28,3303,5008,6.13,0.1,12.06,18.29
54015020,10464,752,4,27,783,7.19,0.04,0.26,7.48
54017040,2,0,0,2,2,0.0,0.0,100.0,100.0
54020020,16358,1297,16,1026,2339,7.93,0.1,6.27,14.3
54020090,4835,361,3,25,389,7.47,0.06,0.52,8.05
54025010,50857,1372,1873,34458,37703,2.7,3.68,67.75,74.14
54035501,567902,310676,126,19980,330782,54.71,0.02,3.52,58.25
54050010,11388,733,52,1980,2765,6.44,0.46,17.39,24.28
54077210,91062,8569,5471,20036,34076,9.41,6.01,22.0,37.42
55015010,51943,4563,10247,20411,35221,8.78,19.73,39.29,67.81
55015020,14927,1191,58,2419,3668,7.98,0.39,16.21,24.57
56010040,9440,1647,14,142,1803,17.45,0.15,1.5,19.1
56015010,42365,3932,3384,6406,13722,9.28,7.99,15.12,32.39
56015040,9303,835,62,866,1763,8.98,0.67,9.31,18.95
56019010,5986,605,282,921,1808,10.11,4.71,15.39,30.2
56125730,14279,2532,109,1236,3877,17.73,0.76,8.66,27.15
57015010,62950,7779,754,12726,21259,12.36,1.2,20.22,33.77
57025020,80662,9534,2646,25859,38039,11.82,3.28,32.06,47.16
88112901,2577,2114,3,55,2172,82.03,0.12,2.13,84.28
1111500036,40838,4197,354,1749,6300,10.28,0.87,4.28,15.43
1117500060,16187,1416,11,1495,2922,8.75,0.07,9.24,18.05
1206500136,36451,2046,10,87,2143,5.61,0.03,0.24,5.88
1303500074,42666,3117,1456,1121,5694,7.31,3.41,2.63,13.35
1303500129,38118,2431,709,902,4042,6.38,1.86,2.37,10.6
1501500054,34130,2691,649,3796,7136,7.88,1.9,11.12,20.91
1507500207,33,22,1,5,28,66.67,3.03,15.15,84.85
1508500053,42527,4732,9,27,4768,11.13,0.02,0.06,11.21
1509500118,39242,2061,851,10107,13019,5.25,2.17,25.76,33.18
1602500044,29764,1521,33,259,1813,5.11,0.11,0.87,6.09
1602500063,18939,965,46,134,1145,5.1,0.24,0.71,6.05
1602500110,30629,2072,8,217,2297,6.76,0.03,0.71,7.5
2119500111,23858,1253,11,70,1334,5.25,0.05,0.29,5.59
2120000099,6,0,0,6,6,0.0,0.0,100.0,100.0
2120000100,5,0,0,5,5,0.0,0.0,100.0,100.0
2120000102,647594,19581,20,0,19601,3.02,0.0,0.0,3.03
2120000104,632620,23382,7,0,23389,3.7,0.0,0.0,3.7
2120000105,652310,14174,121,21,14316,2.17,0.02,0.0,2.19
2120000106,647686,16477,1077,0,17554,2.54,0.17,0.0,2.71
2120000107,654645,25034,24,2,25060,3.82,0.0,0.0,3.83
2120500050,43707,3129,373,1003,4505,7.16,0.85,2.29,10.31
2120500135,37646,2386,456,2590,5432,6.34,1.21,6.88,14.43
2120500204,1431,0,9,1,10,0.0,0.63,0.07,0.7
2120700037,646043,18797,16,2,18815,2.91,0.0,0.0,2.91
2120700038,641682,22426,19,2,22447,3.49,0.0,0.0,3.5
2120700162,1,0,0,0,0,0.0,0.0,0.0,0.0
2121500042,42243,2587,216,437,3240,6.12,0.51,1.03,7.67
2121500048,16370,1063,77,62,1202,6.49,0.47,0.38,7.34
2201500047,35382,1649,10,15,1674,4.66,0.03,0.04,4.73
2202500051,30592,1569,63,37,1669,5.13,0.21,0.12,5.46
2302500037,32905,1693,5,462,2160,5.15,0.02,1.4,6.56
2302500064,51290,2778,71,541,3390,5.42,0.14,1.05,6.61
2305500055,31335,2008,155,2474,4637,6.41,0.49,7.9,14.8
2306500106,41199,3142,200,377,3719,7.63,0.49,0.92,9.03
2308500068,23112,2117,12,282,2411,9.16,0.05,1.22,10.43
2308500071,45510,3497,42,1615,5154,7.68,0.09,3.55,11.32
2319500043,43092,1690,629,6,2325,3.92,1.46,0.01,5.4
2319500125,46039,2113,191,150,2454,4.59,0.41,0.33,5.33
2319500137,37752,2059,1088,496,3643,5.45,2.88,1.31,9.65
2401500040,42944,2178,61,560,2799,5.07,0.14,1.3,6.52
2401500052,31936,1932,27,123,2082,6.05,0.08,0.39,6.52
2401500080,44385,2775,211,3084,6070,6.25,0.48,6.95,13.68
2401500086,38102,1655,27,42,1724,4.34,0.07,0.11,4.52
2403000117,29003,1471,490,8871,10832,5.07,1.69,30.59,37.35
2403500041,43304,4715,69,656,5440,10.89,0.16,1.51,12.56
2403500081,27189,2854,16,73,2943,10.5,0.06,0.27,10.82
2403500082,38426,3618,110,60,3788,9.42,0.29,0.16,9.86
2403500083,42010,1747,33,546,2326,4.16,0.08,1.3,5.54
2403500084,44095,1976,200,68,2244,4.48,0.45,0.15,5.09
2403500085,44126,2221,68,130,2419,5.03,0.15,0.29,5.48
2501500120,44759,4582,12,337,4931,10.24,0.03,0.75,11.02
2603500127,37853,2898,30,856,3784,7.66,0.08,2.26,10.0
2604500039,27491,1666,77,2869,4612,6.06,0.28,10.44,16.78
2604500134,47799,3131,29,655,3815,6.55,0.06,1.37,7.98
2610500131,30598,1801,319,443,2563,5.89,1.04,1.45,8.38
2612500038,31899,1514,29,127,1670,4.75,0.09,0.4,5.24
2612500124,49775,2330,198,163,2691,4.68,0.4,0.33,5.41
2612500130,30104,2048,304,234,2586,6.8,1.01,0.78,8.59
2612500210,5387,0,109,0,109,0.0,2.02,0.0,2.02
2612500211,5405,0,65,1,66,0.0,1.2,0.02,1.22
2612500212,5336,0,86,0,86,0.0,1.61,0.0,1.61
2612500213,5407,0,72,1,73,0.0,1.33,0.02,1.35
2612500214,5407,0,97,0,97,0.0,1.79,0.0,1.79
2612500215,5415,0,73,0,73,0.0,1.35,0.0,1.35
2613500126,33983,1702,157,134,1993,5.01,0.46,0.39,5.86
2614500112,35990,7037,62,588,7687,19.55,0.17,1.63,21.36
2614500116,50808,3959,133,731,4823,7.79,0.26,1.44,9.49
2615500122,44727,2923,600,1241,4764,6.54,1.34,2.77,10.65
2621500070,24535,1510,56,271,1837,6.15,0.23,1.1,7.49
2701500105,10216,505,12,103,620,4.94,0.12,1.01,6.07
2702500107,52767,2397,39,545,2981,4.54,0.07,1.03,5.65
2801500078,27780,1511,19,11,1541,5.44,0.07,0.04,5.55
2802500079,44371,2436,35,57,2528,5.49,0.08,0.13,5.7
2804500076,24146,950,1846,7180,9976,3.93,7.65,29.74,41.32
2805500075,35675,3919,35,213,4167,10.99,0.1,0.6,11.68
2901500072,37448,3554,2644,9914,16112,9.49,7.06,26.47,43.02
2906500077,39113,3555,420,367,4342,9.09,1.07,0.94,11.1
3206500045,19078,1052,1086,3823,5961,5.51,5.69,20.04,31.25
3206500058,29149,1668,37,180,1885,5.72,0.13,0.62,6.47
3206500059,29348,2527,24,595,3146,8.61,0.08,2.03,10.72
3502500135,36883,2956,91,1556,4603,8.01,0.25,4.22,12.48
3503500062,37017,2096,102,2312,4510,5.66,0.28,6.25,12.18
3505500061,27182,1819,24,752,2595,6.69,0.09,2.77,9.55
3507500046,43856,2878,23,238,3139,6.56,0.05,0.54,7.16
3507500133,44261,2884,438,7118,10440,6.52,0.99,16.08,23.59
3518500127,32195,2307,276,94,2677,7.17,0.86,0.29,8.31
3526500201,14163,876,65,1136,2077,6.19,0.46,8.02,14.66
3701500114,46969,2824,285,1053,4162,6.01,0.61,2.24,8.86
3701500117,40201,2695,1254,894,4843,6.7,3.12,2.22,12.05
3702500113,28706,1973,88,1868,3929,6.87,0.31,6.51,13.69
3706500109,28871,1807,17,694,2518,6.26,0.06,2.4,8.72
5102500128,37105,5967,420,10125,16512,16.08,1.13,27.29,44.5
5202500132,37495,2049,211,523,2783,5.46,0.56,1.39,7.42
5205500123,31160,2232,44,244,2520,7.16,0.14,0.78,8.09
5311500056,33312,2800,47,3951,6798,8.41,0.14,11.86,20.41
5311500121,51489,3556,71,2316,5943,6.91,0.14,4.5,11.54
5311500147,155680,0,110,5,115,0.0,0.07,0.0,0.07
5311500149,136191,70231,108,26,70365,51.57,0.08,0.02,51.67
